16 16
7 14 2 10 3 6 3 6 10 10 3 6 3 14 2 3 
12 3 12 3 12 9 12 9 6 10 9 5 12 10 9 5 
7 12 3 4 10 10 2 3 12 10 3 5 14 2 11 5 
4 3 5 13 6 3 5 5 6 3 5 12 3 5 6 9 
5 5 12 3 5 5 13 5 13 5 12 10 9 5 5 7 
5 12 10 9 5 5 6 9 6 8 2 10 10 1 12 1 
12 3 6 2 9 12 9 7 4 3 13 6 3 13 6 9 
6 9 5 12 10 3 6 8 9 12 10 9 5 6 9 7 
5 14 8 11 6 9 12 10 10 10 3 6 9 12 10 0 
12 10 10 3 12 10 2 10 3 6 9 12 2 10 11 5 
6 10 11 12 10 3 12 3 5 12 10 3 12 10 10 9 
8 10 3 6 3 5 14 9 12 3 7 12 10 3 14 3 
6 10 1 5 12 9 6 10 10 9 4 10 11 12 3 5 
5 6 9 12 3 6 9 6 10 10 1 6 10 10 9 5 
5 13 6 10 9 5 6 9 6 3 13 5 14 2 3 5 
12 10 8 10 10 9 12 10 9 12 10 8 10 9 12 9 
